12,20
++++++++++++++++++++
+       g          +
+ + + ++++ + +++++ +
+ + +++ ++ + ++ ++ +
+ +   +    + ++    +
+ +++ ++++++ +++++++
+  s+     ++ + +   +
+ +++++++ ++ + +++++
+ +       ++ +     +
++++++++++++ +++++ +
+                  +
++++++++++++++++++++
