12,20
++++++++++++++++++++
+                  +
+ + + ++++ + +++++ +
+ + +++ ++ + ++ ++ +
+ +   +    + ++    +
+ +++ ++++++ +++++++
+  s+     ++ +    g+
+ +++++++ ++ + +++++
+ +       ++ +     +
++++++++++++ +++++ +
+                  +
++++++++++++++++++++